#####B###
#####A###
####    #
####   ##
       ##
#########